R 2000 100
EA ./pics/colorstone.png
NO ./pics/wood.png
WE ./pics/purplestone.png
SO ./pics/eagle.png
S ./pics/barrel.png
F 2, 30, 2
C 50, 33, 49


        1111111111111111111111111
        1000000000110000000000001
        1011000001110000002000001
        1001000000000000000200001
1111111110110000011100000000000011111111111
1000000000110000011101111000000000000000001
1111011111111101110000001000000000000000001
111101111111110111010100100S200200200020001
1100000011010101110000001000000000000000001
1000200000000000110000001000000000000000001
1000000000000000110101000000000000000000001
1100000111010101111100000000111111111111111
11110111 1110101 101111000001
11111101 1111111 111111111111
